W1 assets/textures/textures_bonus/spacewall.xpm
W2 assets/textures/textures_bonus/window.xpm
W3 assets/textures/textures_bonus/control.xpm
W4 assets/textures/textures_bonus/view.xpm
HO assets/textures/textures_bonus/incubateurs.xpm
DO assets/textures/textures_bonus/door2.xpm
E1 assets/textures/textures_bonus/xeno.xpm
E2 assets/textures/textures_bonus/xeno2.xpm
E3 assets/textures/textures_bonus/xeno.xpm

A1 assets/textures/textures_bonus/detector1.xpm
A2 assets/textures/textures_bonus/detector2.xpm
A3 assets/textures/textures_bonus/zoom_detector_ping.xpm
A4 assets/textures/textures_bonus/zoom_detector.xpm

C 60,60,60
F 50,50,50

112111121121121121121121121111111111121211
100000000000000000000000000000001000000001
111111111111S1111111111111101111100HHHH001
100000000001111111M1111111100000D000000001
1M111111110000000000000000001111100HH0H001
10000000000111111111111111111111100HH0H001
111D11111111111111111111111111111111111111
1000002
1000002
4443444
