W1 assets/textures/textures_bonus/just_a_wall.xpm
W2 assets/textures/textures_bonus/titan_in_the_wall.xpm
W3 assets/textures/textures_bonus/wall_berthhold.xpm
W4 assets/textures/textures_bonus/wall_maria.xpm
HO assets/textures/textures_bonus/house.xpm
DO assets/textures/textures_bonus/door.xpm
E1 assets/textures/textures_bonus/mob1.xpm
E2 assets/textures/textures_bonus/mob2.xpm
E3 assets/textures/textures_bonus/dedmob.xpm

A1 assets/textures/textures_bonus/arme2.xpm
A2 assets/textures/textures_bonus/arme3.xpm
A3 assets/textures/textures_bonus/attack1.xpm
A4 assets/textures/textures_bonus/attack2.xpm

C 0,188,212
F 203,178,117

1111111111111111111111111111111111111
1000000M0000000000000M000000000000004
1000000000HHH00000HHHHHHHH000H0000004
3000000000HHH00000HH00000H0M0H000000D
100HHHHHHHH0M000000H000000000H0HHH004
1S00000000000000HHHH0000000000H000004
1111111111111211111111111111111111111
