NO assets/textures/textures_mandatory/just_a_wall.xpm

F 220,100,0
	SO assets/textures/textures_mandatory/titan_in_the_wall.xpm
EA assets/textures/textures_mandatory/wall_berthhold.xpm

WE assets/textures/textures_mandatory/wall_maria.xpm
C 225,30,0

1111111111111111111111111
10000000001100000000000011111
10110000011100000000111110001
100100000000000000001   10001111111111
11111111101100000111111110000000000001
10000000001100000111011111111111111111
11110111111111011100000010001
11110111111111011101010010001
11000000110101011100000010001
100000W0000000000000000010001
10000000000000001101010010001
1100000111010101111101111000111
11110111 1110101 101111010001
11111111 1111111 111111111111
  