NO assets/textures/texture1.xpm
SO assets/textures/texture1.xpm
WE assets/textures/texture1.xpm
EA assets/textures/texture1.xpm

F 100,100,100
C 150,150,150

11111111111111111111111111111111111111111111111111111111
10000000010000000000011000001     1000000000010000000001
11111000010000001111111000001     1000111111111111110001
10000000010000001000001000001     1000000001000000000001
11111000000001111000001111001111111000001111000000001001
10001111100000001000001001100000100000000110000000011111
10S01110000000111110001001111110001111111110001000000011
10000100000000110000001000000001000011100000001000000001
10000000000000000000000000000000000000000000001000000001
11111111111111111111111111111111111111111111111111111111