NO assets/textures/minimap_wall.xpm
SO assets/textures/minimap_wall.xpm
WE assets/textures/minimap_wall.xpm
EA assets/textures/minimap_wall.xpm

F 100,100,100
C 150,150,150

111111111111
110100000001
100100000W01
100000100001
111111111111