T1 assets/textures/textures_bonus/just_a_wall.xpm
T2 assets/textures/textures_bonus/titan_in_the_wall.xpm
T3 assets/textures/textures_bonus/wall_berthhold.xpm
T4 assets/textures/textures_bonus/wall_maria.xpm
T5 assets/textures/textures_bonus/house.xpm
T6 assets/textures/textures_bonus/
T7 assets/textures/textures_bonus/

C 0,188,212
F 203,178,117 

1111111111111111111111111111111111111
1000000600000000000006000000000000004
1000600000555000005555555500050000004
3000000000555000005500000506050000001
1005555555506000000500000000050555004
1N00000000000000555500000000005000004
1111111111111211111111111111111111111