NO assets/textures/texture1.xpm
SO assets/textures/texture1.xpm
WE assets/textures/texture1.xpm
EA assets/textures/texture1.xpm

F 220,100,0
C 225,30,0

111111111111111111111111111111111111111111111111111111111111111111111111111111111111111111111111111111
100000000000000000000000000011100000100000000000100000000000000010000000000000000000100000000000000101
100000000000000000100000001011000000000000000000100000001000000000000000000100000000000000000100000001
1000000000000000000000000000000000000000000000000000000000000000000000000000000000000000000000000000W1
100000000000000000100000001011000000000000000000100000000000000000000000000000000000000000000000000001
100000000100000000010000000000000010000100000000000000001000000000000010000000000100000000000001000001
111111111111111111111111111111111111111111111111111111111111111111111111111111111111111111111111111111
