NO assets/textures/textures_bonus/just_a_wall.xpm
SO assets/textures/textures_bonus/titan_in_the_wall.xpm
WE assets/textures/textures_bonus/wall_berthhold.xpm
EA assets/textures/textures_bonus/wall_maria.xpm

F 220,100,0
C 225,30,0

111111111111111111111111
10000000000000000000N001
000000000000000000000001
100000000000000000000001
111111111111111111111111