NO assets/textures/textures_bonus/just_a_wall.xpm
SO assets/textures/textures_bonus/titan_in_the_wall.xpm
WE assets/textures/textures_bonus/house.xpm
EA assets/textures/textures_bonus/wall_maria.xpm

C 0,188,212
F 203,178,117 

111111111111
110100000001
100101000W01
100000100001
111111111111
